%%%%%
%.P.%
%. %%
%...%
%%%%%
